//MAP CONVERTED BY dmm2tgm.py THIS HEADER COMMENT PREVENTS RECONVERSION, DO NOT REMOVE
"aa" = (
/turf/space,
/area/space)
"ab" = (
/turf/simulated/floor/shuttle_ceiling,
/area/space)
"ac" = (
/turf/simulated/wall/r_titanium,
/area/space)
"ad" = (
/obj/machinery/atmospherics/unary/engine{
	dir = 8
	},
/turf/simulated/floor/plating,
/area/space)
"ae" = (
/turf/simulated/floor/shuttle_ceiling/sol,
/area/space)
"af" = (
/obj/machinery/door/airlock/multi_tile/civilian,
/turf/simulated/floor/tiled/techfloor/grid,
/area/space)
"ag" = (
/turf/simulated/floor/tiled/techfloor/grid,
/area/space)
"ah" = (
/obj/effect/wallframe_spawn/reinforced,
/turf/simulated/wall/r_titanium,
/area/space)
"ai" = (
/obj/effect/wallframe_spawn/reinforced,
/turf/space,
/area/space)
"aj" = (
/obj/structure/closet/emcloset,
/obj/machinery/light{
	dir = 1
	},
/turf/simulated/floor/tiled/techmaint,
/area/space)
"ak" = (
/obj/effect/floor_decal/spline/fancy{
	dir = 8
	},
/obj/effect/floor_decal/industrial/loading{
	dir = 1
	},
/turf/simulated/floor/tiled/monotile,
/area/space)
"al" = (
/obj/effect/floor_decal/spline/fancy{
	dir = 4
	},
/obj/effect/floor_decal/industrial/loading{
	dir = 1
	},
/turf/simulated/floor/tiled/monotile,
/area/space)
"am" = (
/obj/structure/sign/warning/nosmoking_1{
	pixel_x = -28
	},
/obj/machinery/light{
	dir = 8
	},
/turf/simulated/floor/carpet/blue,
/area/space)
"an" = (
/obj/structure/bed/chair/shuttle/black{
	dir = 8
	},
/obj/structure/closet/walllocker/emerglocker/north,
/turf/simulated/floor/tiled/techmaint,
/area/space)
"ao" = (
/turf/simulated/floor/carpet/blue,
/area/space)
"ap" = (
/obj/structure/bed/chair/shuttle/black{
	dir = 8
	},
/obj/structure/closet/walllocker/emerglocker/north,
/obj/machinery/light{
	dir = 4
	},
/turf/simulated/floor/tiled/techmaint,
/area/space)
"aq" = (
/obj/machinery/portable_atmospherics/canister/air,
/turf/simulated/floor/tiled/monotile,
/area/space)
"ar" = (
/obj/machinery/computer/shuttle_control{
	dir = 4
	},
/turf/simulated/floor/tiled/techmaint,
/area/space)
"as" = (
/obj/structure/bed/chair/shuttle/black{
	dir = 8
	},
/obj/structure/closet/walllocker/emerglocker/east,
/obj/machinery/light{
	dir = 1
	},
/turf/simulated/floor/tiled/techmaint,
/area/space)
"at" = (
/obj/structure/closet/emcloset,
/turf/simulated/floor/tiled/techmaint,
/area/space)
"au" = (
/obj/effect/floor_decal/spline/fancy{
	dir = 8
	},
/turf/simulated/floor/tiled/monotile,
/area/space)
"av" = (
/obj/effect/floor_decal/spline/fancy{
	dir = 4
	},
/turf/simulated/floor/tiled/monotile,
/area/space)
"aw" = (
/obj/machinery/status_display{
	pixel_x = -32
	},
/turf/simulated/floor/carpet/blue,
/area/space)
"ax" = (
/obj/structure/bed/chair/shuttle/black{
	dir = 8
	},
/turf/simulated/floor/tiled/techmaint,
/area/space)
"ay" = (
/turf/simulated/floor/tiled/techmaint,
/area/space)
"az" = (
/obj/structure/table/steel_reinforced,
/turf/simulated/floor/tiled/techmaint,
/area/space)
"aA" = (
/obj/effect/floor_decal/spline/fancy/cee{
	dir = 8
	},
/turf/simulated/floor/tiled/monotile,
/area/space)
"aB" = (
/obj/effect/floor_decal/industrial/hatch,
/obj/machinery/door/airlock/glass/civilian,
/turf/simulated/floor/tiled/monotile,
/area/space)
"aC" = (
/obj/effect/floor_decal/spline/fancy,
/obj/effect/floor_decal/spline/fancy{
	dir = 1
	},
/turf/simulated/floor/tiled/monotile,
/area/space)
"aD" = (
/obj/effect/floor_decal/spline/fancy{
	dir = 4;
	icon_state = "spline_fancy_corner"
	},
/obj/effect/floor_decal/spline/fancy{
	dir = 8;
	icon_state = "spline_fancy_corner"
	},
/turf/simulated/floor/tiled/monotile,
/area/space)
"aE" = (
/obj/effect/floor_decal/spline/fancy{
	icon_state = "spline_fancy_corner"
	},
/obj/effect/floor_decal/spline/fancy{
	dir = 1;
	icon_state = "spline_fancy_corner"
	},
/turf/simulated/floor/tiled/monotile,
/area/space)
"aF" = (
/obj/effect/floor_decal/spline/fancy{
	dir = 1
	},
/obj/effect/floor_decal/spline/fancy,
/obj/effect/floor_decal/small_carpet{
	dir = 10
	},
/turf/simulated/floor/tiled/monotile,
/area/space)
"aG" = (
/obj/effect/floor_decal/spline/fancy{
	dir = 1
	},
/obj/effect/floor_decal/spline/fancy,
/obj/effect/floor_decal/small_carpet,
/turf/simulated/floor/tiled/monotile,
/area/space)
"aH" = (
/obj/effect/floor_decal/spline/fancy{
	dir = 1
	},
/obj/effect/floor_decal/spline/fancy,
/obj/effect/floor_decal/small_carpet{
	dir = 8
	},
/turf/simulated/floor/tiled/monotile,
/area/space)
"aI" = (
/obj/machinery/door/airlock/civilian,
/turf/simulated/floor/tiled/techfloor/grid,
/area/space)
"aJ" = (
/obj/machinery/power/port_gen/pacman/mrs,
/turf/simulated/floor/tiled/monotile,
/area/space)
"aK" = (
/obj/machinery/power/smes/buildable/power_shuttle,
/turf/simulated/floor/tiled/monotile,
/area/space)
"aL" = (
/obj/effect/wallframe_spawn/reinforced,
/turf/simulated/floor/plating,
/area/space)
"aM" = (
/turf/simulated/floor/plating,
/area/space)
"aN" = (
/obj/structure/bed/chair/shuttle/black{
	dir = 8
	},
/obj/structure/closet/walllocker/emerglocker/east,
/obj/machinery/light,
/turf/simulated/floor/tiled/techmaint,
/area/space)
"aO" = (
/obj/structure/closet/emcloset,
/obj/machinery/light,
/turf/simulated/floor/tiled/techmaint,
/area/space)
"aP" = (
/obj/effect/floor_decal/spline/fancy{
	dir = 8
	},
/obj/effect/floor_decal/industrial/loading,
/turf/simulated/floor/tiled/monotile,
/area/space)
"aQ" = (
/obj/effect/floor_decal/spline/fancy{
	dir = 4
	},
/obj/effect/floor_decal/industrial/loading,
/turf/simulated/floor/tiled/monotile,
/area/space)
"aR" = (
/obj/structure/bed/chair/shuttle/black{
	dir = 8
	},
/obj/structure/closet/walllocker/emerglocker/south,
/turf/simulated/floor/tiled/techmaint,
/area/space)
"aS" = (
/obj/structure/bed/chair/shuttle/black{
	dir = 8
	},
/obj/structure/closet/walllocker/emerglocker/south,
/obj/machinery/light{
	dir = 4
	},
/turf/simulated/floor/tiled/techmaint,
/area/space)
"aT" = (
/obj/structure/table/rack/dark,
/obj/random/maintenance,
/obj/random/maintenance,
/obj/random/tech_supply,
/turf/simulated/floor/tiled/monotile,
/area/space)
"aU" = (
/obj/structure/dispenser/oxygen,
/turf/simulated/floor/tiled/monotile,
/area/space)
"aV" = (
/obj/structure/sign/warning/nosmoking_1{
	pixel_x = -28
	},
/turf/simulated/floor/carpet/blue,
/area/space)
"aW" = (
/obj/structure/bed/chair/shuttle/black{
	dir = 8
	},
/obj/machinery/light{
	dir = 4
	},
/turf/simulated/floor/tiled/techmaint,
/area/space)
"aX" = (
/obj/machinery/light{
	dir = 8
	},
/turf/simulated/floor/carpet/blue,
/area/space)
"aY" = (
/obj/machinery/door/airlock/sfp,
/turf/space,
/area/space)
"aZ" = (
/obj/structure/closet/emcloset,
/turf/simulated/floor/wood,
/area/space)
"ba" = (
/obj/effect/floor_decal/spline/fancy{
	dir = 8
	},
/obj/effect/floor_decal/industrial/loading{
	dir = 1
	},
/turf/simulated/floor/wood/mahogany,
/area/space)
"bb" = (
/obj/effect/floor_decal/spline/fancy{
	dir = 4
	},
/obj/effect/floor_decal/industrial/loading{
	dir = 1
	},
/turf/simulated/floor/wood/mahogany,
/area/space)
"bc" = (
/obj/structure/bed/chair/comfy/beige{
	dir = 4
	},
/turf/simulated/floor/wood,
/area/space)
"bd" = (
/obj/structure/table/woodentable,
/turf/simulated/floor/wood,
/area/space)
"be" = (
/obj/structure/bed/chair/comfy/beige{
	dir = 8
	},
/turf/simulated/floor/wood,
/area/space)
"bf" = (
/turf/simulated/floor/wood,
/area/space)
"bg" = (
/obj/machinery/portable_atmospherics/canister/air,
/turf/simulated/floor/tiled/dark/monotile,
/area/space)
"bh" = (
/obj/machinery/computer/shuttle_control{
	dir = 4
	},
/turf/simulated/floor/wood,
/area/space)
"bi" = (
/obj/structure/bed/chair/shuttle/black{
	dir = 8
	},
/obj/structure/closet/walllocker/emerglocker/east,
/turf/simulated/floor/wood,
/area/space)
"bj" = (
/obj/effect/floor_decal/spline/fancy{
	dir = 8
	},
/turf/simulated/floor/wood/mahogany,
/area/space)
"bk" = (
/obj/effect/floor_decal/spline/fancy{
	dir = 4
	},
/turf/simulated/floor/wood/mahogany,
/area/space)
"bm" = (
/obj/structure/table/steel_reinforced,
/turf/simulated/floor/wood,
/area/space)
"bn" = (
/obj/effect/floor_decal/spline/fancy/cee{
	dir = 8
	},
/turf/simulated/floor/wood/mahogany,
/area/space)
"bo" = (
/obj/effect/floor_decal/spline/fancy{
	dir = 1
	},
/obj/effect/floor_decal/spline/fancy,
/obj/effect/floor_decal/industrial/hatch,
/obj/machinery/door/airlock/glass/civilian,
/turf/simulated/floor/wood/mahogany,
/area/space)
"bp" = (
/obj/effect/floor_decal/spline/fancy,
/obj/effect/floor_decal/spline/fancy{
	dir = 1
	},
/turf/simulated/floor/wood/mahogany,
/area/space)
"bq" = (
/obj/effect/floor_decal/spline/fancy{
	dir = 4;
	icon_state = "spline_fancy_corner"
	},
/obj/effect/floor_decal/spline/fancy{
	dir = 8;
	icon_state = "spline_fancy_corner"
	},
/turf/simulated/floor/wood/mahogany,
/area/space)
"br" = (
/obj/effect/floor_decal/spline/fancy{
	icon_state = "spline_fancy_corner"
	},
/obj/effect/floor_decal/spline/fancy{
	dir = 1;
	icon_state = "spline_fancy_corner"
	},
/turf/simulated/floor/wood/mahogany,
/area/space)
"bs" = (
/obj/effect/floor_decal/spline/fancy,
/obj/effect/floor_decal/spline/fancy{
	dir = 1
	},
/obj/effect/floor_decal/industrial/hatch,
/obj/machinery/door/airlock/glass/civilian,
/turf/simulated/floor/wood/mahogany,
/area/space)
"bt" = (
/obj/effect/floor_decal/spline/fancy,
/obj/effect/floor_decal/spline/fancy{
	dir = 1
	},
/obj/effect/floor_decal/small_carpet{
	dir = 10
	},
/turf/simulated/floor/wood/mahogany,
/area/space)
"bu" = (
/obj/effect/floor_decal/spline/fancy,
/obj/effect/floor_decal/spline/fancy{
	dir = 1
	},
/obj/effect/floor_decal/small_carpet,
/turf/simulated/floor/wood/mahogany,
/area/space)
"bv" = (
/obj/effect/floor_decal/spline/fancy,
/obj/effect/floor_decal/spline/fancy{
	dir = 1
	},
/obj/effect/floor_decal/small_carpet{
	dir = 8
	},
/turf/simulated/floor/wood/mahogany,
/area/space)
"bw" = (
/obj/machinery/power/port_gen/pacman/mrs,
/turf/simulated/floor/tiled/dark/monotile,
/area/space)
"bx" = (
/obj/machinery/power/smes/buildable/power_shuttle,
/turf/simulated/floor/tiled/dark/monotile,
/area/space)
"by" = (
/obj/effect/floor_decal/spline/fancy{
	dir = 8
	},
/obj/effect/floor_decal/industrial/loading,
/turf/simulated/floor/wood/mahogany,
/area/space)
"bz" = (
/obj/effect/floor_decal/spline/fancy{
	dir = 4
	},
/obj/effect/floor_decal/industrial/loading,
/turf/simulated/floor/wood/mahogany,
/area/space)
"bA" = (
/obj/structure/table/rack/dark,
/obj/random/maintenance,
/obj/random/maintenance,
/obj/random/tech_supply,
/turf/simulated/floor/tiled/dark/monotile,
/area/space)
"bB" = (
/obj/structure/dispenser/oxygen,
/turf/simulated/floor/tiled/dark/monotile,
/area/space)

(1,1,1) = {"
aa
aa
aa
aa
aa
aa
aa
aa
aa
aa
aa
aa
aa
aa
aa
aa
aa
aa
aa
aa
aa
aa
aa
aa
aa
aa
aa
aa
aa
aa
aa
aa
aa
aa
aa
aa
aa
aa
aa
aa
aa
aa
aa
aa
aa
aa
aa
aa
aa
aa
"}
(2,1,1) = {"
aa
aa
aa
aa
ac
ai
ai
ai
ac
aa
aa
aa
aa
aa
aa
aa
aa
aa
aa
aa
aa
aa
aa
aa
aa
aa
aa
aa
aa
aa
aa
aa
aa
aa
aa
aa
aa
aa
aa
aa
aa
aa
aa
aa
aa
aa
aa
aa
aa
aa
"}
(3,1,1) = {"
aa
aa
aa
ab
ai
ar
az
ar
ai
ab
aa
aa
aa
aa
aa
aa
aa
aa
aa
aa
aa
aa
aa
aa
aa
aa
aa
aa
aa
aa
aa
ac
ai
ai
ai
ac
aa
aa
aa
aa
aa
aa
aa
aa
aa
aa
aa
aa
aa
aa
"}
(4,1,1) = {"
aa
aa
aa
ab
ac
as
aA
aN
ac
ab
aa
aa
aa
aa
aa
aa
aa
ac
ai
ai
ai
ac
aa
aa
aa
aa
aa
aa
aa
aa
aa
ai
bh
bm
bh
ai
aa
aa
aa
aa
aa
aa
aa
aa
aa
aa
aa
aa
aa
aa
"}
(5,1,1) = {"
aa
aa
aa
ac
ac
ac
aB
ac
ac
ac
aa
aa
aa
aa
aa
aa
ae
ai
ar
az
ar
ai
ae
aa
aa
aa
aa
aa
aa
aa
aa
ac
bi
bn
bi
ac
aa
aa
aa
aa
aa
aa
aa
aa
aa
aa
aa
aa
aa
aa
"}
(6,1,1) = {"
aa
aa
aa
ac
aj
at
aC
at
aO
ac
aa
aa
aa
aa
aa
ab
ae
ac
as
aA
aN
ac
ae
ab
aa
aa
aa
aa
aa
aa
ac
ac
ac
bo
ac
ac
ac
aa
aa
aa
aa
aa
aa
aa
aa
aa
aa
aa
aa
aa
"}
(7,1,1) = {"
aa
aa
aa
af
ak
au
aD
au
aP
af
aa
aa
aa
aa
aa
ab
ac
ac
ac
aB
ac
ac
ac
ab
aa
aa
aa
aa
aa
aa
ac
aZ
aZ
bp
aZ
aZ
ac
aa
aa
aa
aa
aa
aa
aa
aa
aa
aa
aa
aa
aa
"}
(8,1,1) = {"
aa
aa
aa
ag
al
av
aE
av
aQ
ag
aa
aa
aa
aa
aa
ac
ac
aj
at
aC
at
aO
ac
ac
aa
aa
aa
aa
aa
aa
aY
ba
bj
bq
bj
by
aY
aa
aa
aa
aa
aa
aa
aa
aa
aa
aa
aa
aa
aa
"}
(9,1,1) = {"
aa
aa
aa
ac
ac
ac
aB
ac
ac
ac
aa
aa
aa
aa
aa
af
ak
au
au
aD
au
au
aP
af
aa
aa
aa
aa
aa
aa
aY
bb
bk
br
bk
bz
aY
aa
aa
aa
aa
aa
aa
aa
aa
aa
aa
aa
aa
aa
"}
(10,1,1) = {"
aa
aa
aa
ah
am
aw
aF
aw
am
ah
aa
aa
aa
aa
aa
ag
al
av
av
aE
av
av
aQ
ag
aa
aa
aa
aa
aa
aa
ac
ac
ac
bs
ac
ac
ac
aa
aa
aa
aa
aa
aa
aa
aa
aa
aa
aa
aa
aa
"}
(11,1,1) = {"
aa
aa
aa
ac
an
ax
aG
ax
aR
ac
aa
aa
aa
aa
aa
ac
ac
ac
ac
aB
ac
ac
ac
ac
aa
aa
aa
aa
aa
ab
ac
bc
bc
bt
bc
bc
ac
ab
aa
aa
aa
aa
aa
aa
aa
aa
aa
aa
aa
aa
"}
(12,1,1) = {"
aa
aa
aa
ah
ao
ao
aG
ao
ao
ah
aa
aa
aa
aa
aa
ah
aV
aw
aX
aF
aX
aw
aV
ah
aa
aa
aa
aa
aa
ab
ai
bd
bd
bu
bd
bd
ai
ab
aa
aa
aa
aa
aa
aa
aa
aa
aa
aa
aa
aa
"}
(13,1,1) = {"
aa
aa
aa
ac
an
ax
aG
ax
aR
ac
aa
aa
aa
aa
aa
ac
an
ax
ax
aG
ax
ax
aR
ac
aa
aa
aa
aa
aa
ab
ac
be
be
bu
be
be
ac
ab
aa
aa
aa
aa
aa
aa
aa
aa
aa
aa
aa
aa
"}
(14,1,1) = {"
aa
aa
aa
ah
ao
ao
aG
ao
ao
ah
aa
aa
aa
aa
aa
ah
ao
ao
ao
aG
ao
ao
ao
ah
aa
aa
aa
aa
aa
ab
ai
bf
bf
bu
bf
bf
ai
ab
aa
aa
aa
aa
aa
aa
aa
aa
aa
aa
aa
aa
"}
(15,1,1) = {"
aa
aa
aa
ac
an
ax
aG
ax
aR
ac
aa
aa
aa
aa
aa
ac
an
ax
ax
aG
ax
ax
aR
ac
aa
aa
aa
aa
aa
ab
ac
bc
bc
bu
bc
bc
ac
ab
aa
aa
aa
aa
aa
aa
aa
aa
aa
aa
aa
aa
"}
(16,1,1) = {"
aa
aa
aa
ah
ao
ao
aG
ao
ao
ah
aa
aa
aa
aa
ae
ah
ao
ao
ao
aG
ao
ao
ao
ah
ae
aa
aa
aa
ab
ab
ai
bd
bd
bu
bd
bd
ai
ab
ab
aa
aa
aa
aa
aa
aa
aa
aa
aa
aa
aa
"}
(17,1,1) = {"
aa
aa
ae
ac
ap
ax
aH
ax
aS
ac
ae
aa
aa
ab
ae
ac
an
ax
ax
aG
ax
ax
aR
ac
ae
ab
aa
aa
ab
ab
ac
be
be
bv
be
be
ac
ab
ab
aa
aa
aa
aa
aa
aa
aa
aa
aa
aa
aa
"}
(18,1,1) = {"
aa
ab
ae
ac
ac
ac
aI
ac
ac
ac
ae
ab
aa
ab
ae
ah
ao
ao
ao
aG
ao
ao
ao
ah
ae
ab
aa
aa
ab
ab
ac
ac
ac
aI
ac
ac
ac
ab
ab
aa
aa
aa
aa
aa
aa
aa
aa
aa
aa
aa
"}
(19,1,1) = {"
aa
ab
ae
ac
aq
ay
ay
ay
aT
ac
ae
ab
aa
ab
ae
ac
an
aW
ax
aH
ax
aW
aR
ac
ae
ab
aa
ab
ac
ac
ac
bg
aa
aa
aa
bA
ac
ac
ac
ab
aa
aa
aa
aa
aa
aa
aa
aa
aa
aa
"}
(20,1,1) = {"
aa
ac
ac
ac
aq
ay
aJ
ay
aU
ac
ac
ac
aa
ac
ac
ac
ac
ac
ac
aI
ac
ac
ac
ac
ac
ac
aa
ac
ac
ac
ac
bg
aa
bw
aa
bB
ac
ac
ac
ac
aa
aa
aa
aa
aa
aa
aa
aa
aa
aa
"}
(21,1,1) = {"
aa
ad
ad
ac
ac
ay
aK
ay
ac
ac
ad
ad
aa
ad
ad
ac
ac
aq
ay
ay
ay
aT
ac
ac
ad
ad
aa
ad
ad
ad
ac
ac
aa
bx
aa
ac
ac
ad
ad
ad
aa
aa
aa
aa
aa
aa
aa
aa
aa
aa
"}
(22,1,1) = {"
aa
aa
aa
ad
ac
ac
aL
ac
ac
ad
aa
aa
aa
aa
aa
ad
ac
aq
ay
aJ
ay
aU
ac
ad
aa
aa
aa
aa
aa
aa
aa
ac
ac
aL
ac
ac
aa
aa
aa
aa
aa
aa
aa
aa
aa
aa
aa
aa
aa
aa
"}
(23,1,1) = {"
aa
aa
aa
aa
aa
ac
aM
ac
aa
aa
aa
aa
aa
aa
aa
aa
ac
ac
ay
aK
ay
ac
ac
aa
aa
aa
aa
aa
aa
aa
aa
aa
ac
aM
ac
aa
aa
aa
aa
aa
aa
aa
aa
aa
aa
aa
aa
aa
aa
aa
"}
(24,1,1) = {"
aa
aa
aa
aa
aa
aa
aa
aa
aa
aa
aa
aa
aa
aa
aa
aa
aa
ac
ac
aL
ac
ac
aa
aa
aa
aa
aa
aa
aa
aa
aa
aa
aa
aa
aa
aa
aa
aa
aa
aa
aa
aa
aa
aa
aa
aa
aa
aa
aa
aa
"}
(25,1,1) = {"
aa
aa
aa
aa
aa
aa
aa
aa
aa
aa
aa
aa
aa
aa
aa
aa
aa
aa
ac
aM
ac
aa
aa
aa
aa
aa
aa
aa
aa
aa
aa
aa
aa
aa
aa
aa
aa
aa
aa
aa
aa
aa
aa
aa
aa
aa
aa
aa
aa
aa
"}
(26,1,1) = {"
aa
aa
aa
aa
aa
aa
aa
aa
aa
aa
aa
aa
aa
aa
aa
aa
aa
aa
aa
aa
aa
aa
aa
aa
aa
aa
aa
aa
aa
aa
aa
aa
aa
aa
aa
aa
aa
aa
aa
aa
aa
aa
aa
aa
aa
aa
aa
aa
aa
aa
"}
(27,1,1) = {"
aa
aa
aa
aa
aa
aa
aa
aa
aa
aa
aa
aa
aa
aa
aa
aa
aa
aa
aa
aa
aa
aa
aa
aa
aa
aa
aa
aa
aa
aa
aa
aa
aa
aa
aa
aa
aa
aa
aa
aa
aa
aa
aa
aa
aa
aa
aa
aa
aa
aa
"}
(28,1,1) = {"
aa
aa
aa
aa
aa
aa
aa
aa
aa
aa
aa
aa
aa
aa
aa
aa
aa
aa
aa
aa
aa
aa
aa
aa
aa
aa
aa
aa
aa
aa
aa
aa
aa
aa
aa
aa
aa
aa
aa
aa
aa
aa
aa
aa
aa
aa
aa
aa
aa
aa
"}
(29,1,1) = {"
aa
aa
aa
aa
aa
aa
aa
aa
aa
aa
aa
aa
aa
aa
aa
aa
aa
aa
aa
aa
aa
aa
aa
aa
aa
aa
aa
aa
aa
aa
aa
aa
aa
aa
aa
aa
aa
aa
aa
aa
aa
aa
aa
aa
aa
aa
aa
aa
aa
aa
"}
(30,1,1) = {"
aa
aa
aa
aa
aa
aa
aa
aa
aa
aa
aa
aa
aa
aa
aa
aa
aa
aa
aa
aa
aa
aa
aa
aa
aa
aa
aa
aa
aa
aa
aa
aa
aa
aa
aa
aa
aa
aa
aa
aa
aa
aa
aa
aa
aa
aa
aa
aa
aa
aa
"}
(31,1,1) = {"
aa
aa
aa
aa
aa
aa
aa
aa
aa
aa
aa
aa
aa
aa
aa
aa
aa
aa
aa
aa
aa
aa
aa
aa
aa
aa
aa
aa
aa
aa
aa
aa
aa
aa
aa
aa
aa
aa
aa
aa
aa
aa
aa
aa
aa
aa
aa
aa
aa
aa
"}
(32,1,1) = {"
aa
aa
aa
aa
aa
aa
aa
aa
aa
aa
aa
aa
aa
aa
aa
aa
aa
aa
aa
aa
aa
aa
aa
aa
aa
aa
aa
aa
aa
aa
aa
aa
aa
aa
aa
aa
aa
aa
aa
aa
aa
aa
aa
aa
aa
aa
aa
aa
aa
aa
"}
(33,1,1) = {"
aa
aa
aa
aa
aa
aa
aa
aa
aa
aa
aa
aa
aa
aa
aa
aa
aa
aa
aa
aa
aa
aa
aa
aa
aa
aa
aa
aa
aa
aa
aa
aa
aa
aa
aa
aa
aa
aa
aa
aa
aa
aa
aa
aa
aa
aa
aa
aa
aa
aa
"}
(34,1,1) = {"
aa
aa
aa
aa
aa
aa
aa
aa
aa
aa
aa
aa
aa
aa
aa
aa
aa
aa
aa
aa
aa
aa
aa
aa
aa
aa
aa
aa
aa
aa
aa
aa
aa
aa
aa
aa
aa
aa
aa
aa
aa
aa
aa
aa
aa
aa
aa
aa
aa
aa
"}
(35,1,1) = {"
aa
aa
aa
aa
aa
aa
aa
aa
aa
aa
aa
aa
aa
aa
aa
aa
aa
aa
aa
aa
aa
aa
aa
aa
aa
aa
aa
aa
aa
aa
aa
aa
aa
aa
aa
aa
aa
aa
aa
aa
aa
aa
aa
aa
aa
aa
aa
aa
aa
aa
"}
(36,1,1) = {"
aa
aa
aa
aa
aa
aa
aa
aa
aa
aa
aa
aa
aa
aa
aa
aa
aa
aa
aa
aa
aa
aa
aa
aa
aa
aa
aa
aa
aa
aa
aa
aa
aa
aa
aa
aa
aa
aa
aa
aa
aa
aa
aa
aa
aa
aa
aa
aa
aa
aa
"}
(37,1,1) = {"
aa
aa
aa
aa
aa
aa
aa
aa
aa
aa
aa
aa
aa
aa
aa
aa
aa
aa
aa
aa
aa
aa
aa
aa
aa
aa
aa
aa
aa
aa
aa
aa
aa
aa
aa
aa
aa
aa
aa
aa
aa
aa
aa
aa
aa
aa
aa
aa
aa
aa
"}
(38,1,1) = {"
aa
aa
aa
aa
aa
aa
aa
aa
aa
aa
aa
aa
aa
aa
aa
aa
aa
aa
aa
aa
aa
aa
aa
aa
aa
aa
aa
aa
aa
aa
aa
aa
aa
aa
aa
aa
aa
aa
aa
aa
aa
aa
aa
aa
aa
aa
aa
aa
aa
aa
"}
(39,1,1) = {"
aa
aa
aa
aa
aa
aa
aa
aa
aa
aa
aa
aa
aa
aa
aa
aa
aa
aa
aa
aa
aa
aa
aa
aa
aa
aa
aa
aa
aa
aa
aa
aa
aa
aa
aa
aa
aa
aa
aa
aa
aa
aa
aa
aa
aa
aa
aa
aa
aa
aa
"}
(40,1,1) = {"
aa
aa
aa
aa
aa
aa
aa
aa
aa
aa
aa
aa
aa
aa
aa
aa
aa
aa
aa
aa
aa
aa
aa
aa
aa
aa
aa
aa
aa
aa
aa
aa
aa
aa
aa
aa
aa
aa
aa
aa
aa
aa
aa
aa
aa
aa
aa
aa
aa
aa
"}
(41,1,1) = {"
aa
aa
aa
aa
aa
aa
aa
aa
aa
aa
aa
aa
aa
aa
aa
aa
aa
aa
aa
aa
aa
aa
aa
aa
aa
aa
aa
aa
aa
aa
aa
aa
aa
aa
aa
aa
aa
aa
aa
aa
aa
aa
aa
aa
aa
aa
aa
aa
aa
aa
"}
(42,1,1) = {"
aa
aa
aa
aa
aa
aa
aa
aa
aa
aa
aa
aa
aa
aa
aa
aa
aa
aa
aa
aa
aa
aa
aa
aa
aa
aa
aa
aa
aa
aa
aa
aa
aa
aa
aa
aa
aa
aa
aa
aa
aa
aa
aa
aa
aa
aa
aa
aa
aa
aa
"}
(43,1,1) = {"
aa
aa
aa
aa
aa
aa
aa
aa
aa
aa
aa
aa
aa
aa
aa
aa
aa
aa
aa
aa
aa
aa
aa
aa
aa
aa
aa
aa
aa
aa
aa
aa
aa
aa
aa
aa
aa
aa
aa
aa
aa
aa
aa
aa
aa
aa
aa
aa
aa
aa
"}
(44,1,1) = {"
aa
aa
aa
aa
aa
aa
aa
aa
aa
aa
aa
aa
aa
aa
aa
aa
aa
aa
aa
aa
aa
aa
aa
aa
aa
aa
aa
aa
aa
aa
aa
aa
aa
aa
aa
aa
aa
aa
aa
aa
aa
aa
aa
aa
aa
aa
aa
aa
aa
aa
"}
(45,1,1) = {"
aa
aa
aa
aa
aa
aa
aa
aa
aa
aa
aa
aa
aa
aa
aa
aa
aa
aa
aa
aa
aa
aa
aa
aa
aa
aa
aa
aa
aa
aa
aa
aa
aa
aa
aa
aa
aa
aa
aa
aa
aa
aa
aa
aa
aa
aa
aa
aa
aa
aa
"}
(46,1,1) = {"
aa
aa
aa
aa
aa
aa
aa
aa
aa
aa
aa
aa
aa
aa
aa
aa
aa
aa
aa
aa
aa
aa
aa
aa
aa
aa
aa
aa
aa
aa
aa
aa
aa
aa
aa
aa
aa
aa
aa
aa
aa
aa
aa
aa
aa
aa
aa
aa
aa
aa
"}
(47,1,1) = {"
aa
aa
aa
aa
aa
aa
aa
aa
aa
aa
aa
aa
aa
aa
aa
aa
aa
aa
aa
aa
aa
aa
aa
aa
aa
aa
aa
aa
aa
aa
aa
aa
aa
aa
aa
aa
aa
aa
aa
aa
aa
aa
aa
aa
aa
aa
aa
aa
aa
aa
"}
(48,1,1) = {"
aa
aa
aa
aa
aa
aa
aa
aa
aa
aa
aa
aa
aa
aa
aa
aa
aa
aa
aa
aa
aa
aa
aa
aa
aa
aa
aa
aa
aa
aa
aa
aa
aa
aa
aa
aa
aa
aa
aa
aa
aa
aa
aa
aa
aa
aa
aa
aa
aa
aa
"}
(49,1,1) = {"
aa
aa
aa
aa
aa
aa
aa
aa
aa
aa
aa
aa
aa
aa
aa
aa
aa
aa
aa
aa
aa
aa
aa
aa
aa
aa
aa
aa
aa
aa
aa
aa
aa
aa
aa
aa
aa
aa
aa
aa
aa
aa
aa
aa
aa
aa
aa
aa
aa
aa
"}
(50,1,1) = {"
aa
aa
aa
aa
aa
aa
aa
aa
aa
aa
aa
aa
aa
aa
aa
aa
aa
aa
aa
aa
aa
aa
aa
aa
aa
aa
aa
aa
aa
aa
aa
aa
aa
aa
aa
aa
aa
aa
aa
aa
aa
aa
aa
aa
aa
aa
aa
aa
aa
aa
"}
