"aa" = (/turf/space,/area/space)
"ab" = (/turf/simulated/floor/shuttle_ceiling,/area/space)
"ac" = (/turf/simulated/wall/r_titanium,/area/space)
"ad" = (/obj/machinery/atmospherics/unary/engine{dir = 8},/turf/simulated/floor/plating,/area/space)
"ae" = (/turf/simulated/floor/shuttle_ceiling/sol,/area/space)
"af" = (/obj/machinery/door/airlock/multi_tile/civilian,/turf/simulated/floor/tiled/techfloor/grid,/area/space)
"ag" = (/turf/simulated/floor/tiled/techfloor/grid,/area/space)
"ah" = (/obj/effect/wallframe_spawn/reinforced,/turf/simulated/wall/r_titanium,/area/space)
"ai" = (/obj/effect/wallframe_spawn/reinforced,/turf/space,/area/space)
"aj" = (/obj/structure/closet/emcloset,/obj/machinery/light{dir = 1},/turf/simulated/floor/tiled/techmaint,/area/space)
"ak" = (/obj/effect/floor_decal/spline/fancy{dir = 8},/obj/effect/floor_decal/industrial/loading{dir = 1},/turf/simulated/floor/tiled/monotile,/area/space)
"al" = (/obj/effect/floor_decal/spline/fancy{dir = 4},/obj/effect/floor_decal/industrial/loading{dir = 1},/turf/simulated/floor/tiled/monotile,/area/space)
"am" = (/obj/structure/sign/warning/nosmoking_1{pixel_x = -28},/obj/machinery/light{dir = 8},/turf/simulated/floor/carpet/blue,/area/space)
"an" = (/obj/structure/bed/chair/shuttle/black{dir = 8},/obj/structure/closet/walllocker/emerglocker/north,/turf/simulated/floor/tiled/techmaint,/area/space)
"ao" = (/turf/simulated/floor/carpet/blue,/area/space)
"ap" = (/obj/structure/bed/chair/shuttle/black{dir = 8},/obj/structure/closet/walllocker/emerglocker/north,/obj/machinery/light{dir = 4},/turf/simulated/floor/tiled/techmaint,/area/space)
"aq" = (/obj/machinery/portable_atmospherics/canister/air,/turf/simulated/floor/tiled/monotile,/area/space)
"ar" = (/obj/machinery/computer/shuttle_control{dir = 4},/turf/simulated/floor/tiled/techmaint,/area/space)
"as" = (/obj/structure/bed/chair/shuttle/black{dir = 8},/obj/structure/closet/walllocker/emerglocker/east,/obj/machinery/light{dir = 1},/turf/simulated/floor/tiled/techmaint,/area/space)
"at" = (/obj/structure/closet/emcloset,/turf/simulated/floor/tiled/techmaint,/area/space)
"au" = (/obj/effect/floor_decal/spline/fancy{dir = 8},/turf/simulated/floor/tiled/monotile,/area/space)
"av" = (/obj/effect/floor_decal/spline/fancy{dir = 4},/turf/simulated/floor/tiled/monotile,/area/space)
"aw" = (/obj/machinery/status_display{pixel_x = -32},/turf/simulated/floor/carpet/blue,/area/space)
"ax" = (/obj/structure/bed/chair/shuttle/black{dir = 8},/turf/simulated/floor/tiled/techmaint,/area/space)
"ay" = (/turf/simulated/floor/tiled/techmaint,/area/space)
"az" = (/obj/structure/table/steel_reinforced,/turf/simulated/floor/tiled/techmaint,/area/space)
"aA" = (/obj/effect/floor_decal/spline/fancy/cee{dir = 8},/turf/simulated/floor/tiled/monotile,/area/space)
"aB" = (/obj/effect/floor_decal/industrial/hatch,/obj/machinery/door/airlock/glass/civilian,/turf/simulated/floor/tiled/monotile,/area/space)
"aC" = (/obj/effect/floor_decal/spline/fancy,/obj/effect/floor_decal/spline/fancy{dir = 1},/turf/simulated/floor/tiled/monotile,/area/space)
"aD" = (/obj/effect/floor_decal/spline/fancy{dir = 4; icon_state = "spline_fancy_corner"},/obj/effect/floor_decal/spline/fancy{dir = 8; icon_state = "spline_fancy_corner"},/turf/simulated/floor/tiled/monotile,/area/space)
"aE" = (/obj/effect/floor_decal/spline/fancy{icon_state = "spline_fancy_corner"},/obj/effect/floor_decal/spline/fancy{dir = 1; icon_state = "spline_fancy_corner"},/turf/simulated/floor/tiled/monotile,/area/space)
"aF" = (/obj/effect/floor_decal/spline/fancy{dir = 1},/obj/effect/floor_decal/spline/fancy,/obj/effect/floor_decal/small_carpet{dir = 10},/turf/simulated/floor/tiled/monotile,/area/space)
"aG" = (/obj/effect/floor_decal/spline/fancy{dir = 1},/obj/effect/floor_decal/spline/fancy,/obj/effect/floor_decal/small_carpet,/turf/simulated/floor/tiled/monotile,/area/space)
"aH" = (/obj/effect/floor_decal/spline/fancy{dir = 1},/obj/effect/floor_decal/spline/fancy,/obj/effect/floor_decal/small_carpet{dir = 8},/turf/simulated/floor/tiled/monotile,/area/space)
"aI" = (/obj/machinery/door/airlock/civilian,/turf/simulated/floor/tiled/techfloor/grid,/area/space)
"aJ" = (/obj/machinery/power/port_gen/pacman/mrs,/turf/simulated/floor/tiled/monotile,/area/space)
"aK" = (/obj/machinery/power/smes/buildable/power_shuttle,/turf/simulated/floor/tiled/monotile,/area/space)
"aL" = (/obj/effect/wallframe_spawn/reinforced,/turf/simulated/floor/plating,/area/space)
"aM" = (/turf/simulated/floor/plating,/area/space)
"aN" = (/obj/structure/bed/chair/shuttle/black{dir = 8},/obj/structure/closet/walllocker/emerglocker/east,/obj/machinery/light,/turf/simulated/floor/tiled/techmaint,/area/space)
"aO" = (/obj/structure/closet/emcloset,/obj/machinery/light,/turf/simulated/floor/tiled/techmaint,/area/space)
"aP" = (/obj/effect/floor_decal/spline/fancy{dir = 8},/obj/effect/floor_decal/industrial/loading,/turf/simulated/floor/tiled/monotile,/area/space)
"aQ" = (/obj/effect/floor_decal/spline/fancy{dir = 4},/obj/effect/floor_decal/industrial/loading,/turf/simulated/floor/tiled/monotile,/area/space)
"aR" = (/obj/structure/bed/chair/shuttle/black{dir = 8},/obj/structure/closet/walllocker/emerglocker/south,/turf/simulated/floor/tiled/techmaint,/area/space)
"aS" = (/obj/structure/bed/chair/shuttle/black{dir = 8},/obj/structure/closet/walllocker/emerglocker/south,/obj/machinery/light{dir = 4},/turf/simulated/floor/tiled/techmaint,/area/space)
"aT" = (/obj/structure/table/rack/dark,/obj/random/maintenance,/obj/random/maintenance,/obj/random/tech_supply,/turf/simulated/floor/tiled/monotile,/area/space)
"aU" = (/obj/structure/dispenser/oxygen,/turf/simulated/floor/tiled/monotile,/area/space)
"aV" = (/obj/structure/sign/warning/nosmoking_1{pixel_x = -28},/turf/simulated/floor/carpet/blue,/area/space)
"aW" = (/obj/structure/bed/chair/shuttle/black{dir = 8},/obj/machinery/light{dir = 4},/turf/simulated/floor/tiled/techmaint,/area/space)
"aX" = (/obj/machinery/light{dir = 8},/turf/simulated/floor/carpet/blue,/area/space)
"aY" = (/obj/machinery/door/airlock/sfp,/turf/space,/area/space)
"aZ" = (/obj/structure/closet/emcloset,/turf/simulated/floor/wood,/area/space)
"ba" = (/obj/effect/floor_decal/spline/fancy{dir = 8},/obj/effect/floor_decal/industrial/loading{dir = 1},/turf/simulated/floor/wood/mahogany,/area/space)
"bb" = (/obj/effect/floor_decal/spline/fancy{dir = 4},/obj/effect/floor_decal/industrial/loading{dir = 1},/turf/simulated/floor/wood/mahogany,/area/space)
"bc" = (/obj/structure/bed/chair/comfy/beige{dir = 4},/turf/simulated/floor/wood,/area/space)
"bd" = (/obj/structure/table/woodentable,/turf/simulated/floor/wood,/area/space)
"be" = (/obj/structure/bed/chair/comfy/beige{dir = 8},/turf/simulated/floor/wood,/area/space)
"bf" = (/turf/simulated/floor/wood,/area/space)
"bg" = (/obj/machinery/portable_atmospherics/canister/air,/turf/simulated/floor/tiled/dark/monotile,/area/space)
"bh" = (/obj/machinery/computer/shuttle_control{dir = 4},/turf/simulated/floor/wood,/area/space)
"bi" = (/obj/structure/bed/chair/shuttle/black{dir = 8},/obj/structure/closet/walllocker/emerglocker/east,/turf/simulated/floor/wood,/area/space)
"bj" = (/obj/effect/floor_decal/spline/fancy{dir = 8},/turf/simulated/floor/wood/mahogany,/area/space)
"bk" = (/obj/effect/floor_decal/spline/fancy{dir = 4},/turf/simulated/floor/wood/mahogany,/area/space)
"bm" = (/obj/structure/table/steel_reinforced,/turf/simulated/floor/wood,/area/space)
"bn" = (/obj/effect/floor_decal/spline/fancy/cee{dir = 8},/turf/simulated/floor/wood/mahogany,/area/space)
"bo" = (/obj/effect/floor_decal/spline/fancy{dir = 1},/obj/effect/floor_decal/spline/fancy,/obj/effect/floor_decal/industrial/hatch,/obj/machinery/door/airlock/glass/civilian,/turf/simulated/floor/wood/mahogany,/area/space)
"bp" = (/obj/effect/floor_decal/spline/fancy,/obj/effect/floor_decal/spline/fancy{dir = 1},/turf/simulated/floor/wood/mahogany,/area/space)
"bq" = (/obj/effect/floor_decal/spline/fancy{dir = 4; icon_state = "spline_fancy_corner"},/obj/effect/floor_decal/spline/fancy{dir = 8; icon_state = "spline_fancy_corner"},/turf/simulated/floor/wood/mahogany,/area/space)
"br" = (/obj/effect/floor_decal/spline/fancy{icon_state = "spline_fancy_corner"},/obj/effect/floor_decal/spline/fancy{dir = 1; icon_state = "spline_fancy_corner"},/turf/simulated/floor/wood/mahogany,/area/space)
"bs" = (/obj/effect/floor_decal/spline/fancy,/obj/effect/floor_decal/spline/fancy{dir = 1},/obj/effect/floor_decal/industrial/hatch,/obj/machinery/door/airlock/glass/civilian,/turf/simulated/floor/wood/mahogany,/area/space)
"bt" = (/obj/effect/floor_decal/spline/fancy,/obj/effect/floor_decal/spline/fancy{dir = 1},/obj/effect/floor_decal/small_carpet{dir = 10},/turf/simulated/floor/wood/mahogany,/area/space)
"bu" = (/obj/effect/floor_decal/spline/fancy,/obj/effect/floor_decal/spline/fancy{dir = 1},/obj/effect/floor_decal/small_carpet,/turf/simulated/floor/wood/mahogany,/area/space)
"bv" = (/obj/effect/floor_decal/spline/fancy,/obj/effect/floor_decal/spline/fancy{dir = 1},/obj/effect/floor_decal/small_carpet{dir = 8},/turf/simulated/floor/wood/mahogany,/area/space)
"bw" = (/obj/machinery/power/port_gen/pacman/mrs,/turf/simulated/floor/tiled/dark/monotile,/area/space)
"bx" = (/obj/machinery/power/smes/buildable/power_shuttle,/turf/simulated/floor/tiled/dark/monotile,/area/space)
"by" = (/obj/effect/floor_decal/spline/fancy{dir = 8},/obj/effect/floor_decal/industrial/loading,/turf/simulated/floor/wood/mahogany,/area/space)
"bz" = (/obj/effect/floor_decal/spline/fancy{dir = 4},/obj/effect/floor_decal/industrial/loading,/turf/simulated/floor/wood/mahogany,/area/space)
"bA" = (/obj/structure/table/rack/dark,/obj/random/maintenance,/obj/random/maintenance,/obj/random/tech_supply,/turf/simulated/floor/tiled/dark/monotile,/area/space)
"bB" = (/obj/structure/dispenser/oxygen,/turf/simulated/floor/tiled/dark/monotile,/area/space)

(1,1,1) = {"
aaaaaaaaaaaaaaaaaaaaaaaaaaaaaaaaaaaaaaaaaaaaaaaaaaaaaaaaaaaaaaaaaaaaaaaaaaaaaaaaaaaaaaaaaaaaaaaaaaaa
aaaaaaaaaaaaaaaaaaaaaaaaaaaaaaaaaaababacadaaaaaaaaaaaaaaaaaaaaaaaaaaaaaaaaaaaaaaaaaaaaaaaaaaaaaaaaaa
aaaaaaaaaaaaaaaaaaaaaaaaaaaaaaaaaeaeaeacadaaaaaaaaaaaaaaaaaaaaaaaaaaaaaaaaaaaaaaaaaaaaaaaaaaaaaaaaaa
aaaaababacacafagacahacahacahacahacacacacacadaaaaaaaaaaaaaaaaaaaaaaaaaaaaaaaaaaaaaaaaaaaaaaaaaaaaaaaa
aaacaiacacajakalacamanaoanaoanaoapacaqaqacacaaaaaaaaaaaaaaaaaaaaaaaaaaaaaaaaaaaaaaaaaaaaaaaaaaaaaaaa
aaaiarasacatauavacawaxaoaxaoaxaoaxacayayayacacaaaaaaaaaaaaaaaaaaaaaaaaaaaaaaaaaaaaaaaaaaaaaaaaaaaaaa
aaaiazaAaBaCaDaEaBaFaGaGaGaGaGaGaHaIayaJaKaLaMaaaaaaaaaaaaaaaaaaaaaaaaaaaaaaaaaaaaaaaaaaaaaaaaaaaaaa
aaaiaraNacatauavacawaxaoaxaoaxaoaxacayayayacacaaaaaaaaaaaaaaaaaaaaaaaaaaaaaaaaaaaaaaaaaaaaaaaaaaaaaa
aaacaiacacaOaPaQacamaRaoaRaoaRaoaSacaTaUacacaaaaaaaaaaaaaaaaaaaaaaaaaaaaaaaaaaaaaaaaaaaaaaaaaaaaaaaa
aaaaababacacafagacahacahacahacahacacacacacadaaaaaaaaaaaaaaaaaaaaaaaaaaaaaaaaaaaaaaaaaaaaaaaaaaaaaaaa
aaaaaaaaaaaaaaaaaaaaaaaaaaaaaaaaaeaeaeacadaaaaaaaaaaaaaaaaaaaaaaaaaaaaaaaaaaaaaaaaaaaaaaaaaaaaaaaaaa
aaaaaaaaaaaaaaaaaaaaaaaaaaaaaaaaaaababacadaaaaaaaaaaaaaaaaaaaaaaaaaaaaaaaaaaaaaaaaaaaaaaaaaaaaaaaaaa
aaaaaaaaaaaaaaaaaaaaaaaaaaaaaaaaaaaaaaaaaaaaaaaaaaaaaaaaaaaaaaaaaaaaaaaaaaaaaaaaaaaaaaaaaaaaaaaaaaaa
aaaaaaaaaaaaaaaaaaaaaaaaaaaaaaaaabababacadaaaaaaaaaaaaaaaaaaaaaaaaaaaaaaaaaaaaaaaaaaaaaaaaaaaaaaaaaa
aaaaaaaaaaaaaaaaaaaaaaaaaaaaaaaeaeaeaeacadaaaaaaaaaaaaaaaaaaaaaaaaaaaaaaaaaaaaaaaaaaaaaaaaaaaaaaaaaa
aaaaaaaaaaababacafagacahacahacahacahacacacadaaaaaaaaaaaaaaaaaaaaaaaaaaaaaaaaaaaaaaaaaaaaaaaaaaaaaaaa
aaaaaaaaaeaeacacakalacaVanaoanaoanaoanacacacacaaaaaaaaaaaaaaaaaaaaaaaaaaaaaaaaaaaaaaaaaaaaaaaaaaaaaa
aaaaaaacaiacacajauavacawaxaoaxaoaxaoaWacaqaqacacaaaaaaaaaaaaaaaaaaaaaaaaaaaaaaaaaaaaaaaaaaaaaaaaaaaa
aaaaaaaiarasacatauavacaXaxaoaxaoaxaoaxacayayayacacaaaaaaaaaaaaaaaaaaaaaaaaaaaaaaaaaaaaaaaaaaaaaaaaaa
aaaaaaaiazaAaBaCaDaEaBaFaGaGaGaGaGaGaHaIayaJaKaLaMaaaaaaaaaaaaaaaaaaaaaaaaaaaaaaaaaaaaaaaaaaaaaaaaaa
aaaaaaaiaraNacatauavacaXaxaoaxaoaxaoaxacayayayacacaaaaaaaaaaaaaaaaaaaaaaaaaaaaaaaaaaaaaaaaaaaaaaaaaa
aaaaaaacaiacacaOauavacawaxaoaxaoaxaoaWacaTaUacacaaaaaaaaaaaaaaaaaaaaaaaaaaaaaaaaaaaaaaaaaaaaaaaaaaaa
aaaaaaaaaeaeacacaPaQacaVaRaoaRaoaRaoaRacacacacaaaaaaaaaaaaaaaaaaaaaaaaaaaaaaaaaaaaaaaaaaaaaaaaaaaaaa
aaaaaaaaaaababacafagacahacahacahacahacacacadaaaaaaaaaaaaaaaaaaaaaaaaaaaaaaaaaaaaaaaaaaaaaaaaaaaaaaaa
aaaaaaaaaaaaaaaaaaaaaaaaaaaaaaaeaeaeaeacadaaaaaaaaaaaaaaaaaaaaaaaaaaaaaaaaaaaaaaaaaaaaaaaaaaaaaaaaaa
aaaaaaaaaaaaaaaaaaaaaaaaaaaaaaaaabababacadaaaaaaaaaaaaaaaaaaaaaaaaaaaaaaaaaaaaaaaaaaaaaaaaaaaaaaaaaa
aaaaaaaaaaaaaaaaaaaaaaaaaaaaaaaaaaaaaaaaaaaaaaaaaaaaaaaaaaaaaaaaaaaaaaaaaaaaaaaaaaaaaaaaaaaaaaaaaaaa
aaaaaaaaaaaaaaaaaaaaaaaaaaaaaaaaaaaaabacadaaaaaaaaaaaaaaaaaaaaaaaaaaaaaaaaaaaaaaaaaaaaaaaaaaaaaaaaaa
aaaaaaaaaaaaaaaaaaaaaaaaaaaaaaabababacacadaaaaaaaaaaaaaaaaaaaaaaaaaaaaaaaaaaaaaaaaaaaaaaaaaaaaaaaaaa
aaaaaaaaaaaaaaaaaaaaababababababababacacadaaaaaaaaaaaaaaaaaaaaaaaaaaaaaaaaaaaaaaaaaaaaaaaaaaaaaaaaaa
aaaaaaaaaaacacaYaYacacaiacaiacaiacacacacacaaaaaaaaaaaaaaaaaaaaaaaaaaaaaaaaaaaaaaaaaaaaaaaaaaaaaaaaaa
aaaaacaiacacaZbabbacbcbdbebfbcbdbeacbgbgacacaaaaaaaaaaaaaaaaaaaaaaaaaaaaaaaaaaaaaaaaaaaaaaaaaaaaaaaa
aaaaaibhbiacaZbjbkacbcbdbebfbcbdbeacaaaaaaacacaaaaaaaaaaaaaaaaaaaaaaaaaaaaaaaaaaaaaaaaaaaaaaaaaaaaaa
aaaaaibmbnbobpbqbrbsbtbubububububvaIaabwbxaLaMaaaaaaaaaaaaaaaaaaaaaaaaaaaaaaaaaaaaaaaaaaaaaaaaaaaaaa
aaaaaibhbiacaZbjbkacbcbdbebfbcbdbeacaaaaaaacacaaaaaaaaaaaaaaaaaaaaaaaaaaaaaaaaaaaaaaaaaaaaaaaaaaaaaa
aaaaacaiacacaZbybzacbcbdbebfbcbdbeacbAbBacacaaaaaaaaaaaaaaaaaaaaaaaaaaaaaaaaaaaaaaaaaaaaaaaaaaaaaaaa
aaaaaaaaaaacacaYaYacacaiacaiacaiacacacacacaaaaaaaaaaaaaaaaaaaaaaaaaaaaaaaaaaaaaaaaaaaaaaaaaaaaaaaaaa
aaaaaaaaaaaaaaaaaaaaababababababababacacadaaaaaaaaaaaaaaaaaaaaaaaaaaaaaaaaaaaaaaaaaaaaaaaaaaaaaaaaaa
aaaaaaaaaaaaaaaaaaaaaaaaaaaaaaabababacacadaaaaaaaaaaaaaaaaaaaaaaaaaaaaaaaaaaaaaaaaaaaaaaaaaaaaaaaaaa
aaaaaaaaaaaaaaaaaaaaaaaaaaaaaaaaaaaaabacadaaaaaaaaaaaaaaaaaaaaaaaaaaaaaaaaaaaaaaaaaaaaaaaaaaaaaaaaaa
aaaaaaaaaaaaaaaaaaaaaaaaaaaaaaaaaaaaaaaaaaaaaaaaaaaaaaaaaaaaaaaaaaaaaaaaaaaaaaaaaaaaaaaaaaaaaaaaaaaa
aaaaaaaaaaaaaaaaaaaaaaaaaaaaaaaaaaaaaaaaaaaaaaaaaaaaaaaaaaaaaaaaaaaaaaaaaaaaaaaaaaaaaaaaaaaaaaaaaaaa
aaaaaaaaaaaaaaaaaaaaaaaaaaaaaaaaaaaaaaaaaaaaaaaaaaaaaaaaaaaaaaaaaaaaaaaaaaaaaaaaaaaaaaaaaaaaaaaaaaaa
aaaaaaaaaaaaaaaaaaaaaaaaaaaaaaaaaaaaaaaaaaaaaaaaaaaaaaaaaaaaaaaaaaaaaaaaaaaaaaaaaaaaaaaaaaaaaaaaaaaa
aaaaaaaaaaaaaaaaaaaaaaaaaaaaaaaaaaaaaaaaaaaaaaaaaaaaaaaaaaaaaaaaaaaaaaaaaaaaaaaaaaaaaaaaaaaaaaaaaaaa
aaaaaaaaaaaaaaaaaaaaaaaaaaaaaaaaaaaaaaaaaaaaaaaaaaaaaaaaaaaaaaaaaaaaaaaaaaaaaaaaaaaaaaaaaaaaaaaaaaaa
aaaaaaaaaaaaaaaaaaaaaaaaaaaaaaaaaaaaaaaaaaaaaaaaaaaaaaaaaaaaaaaaaaaaaaaaaaaaaaaaaaaaaaaaaaaaaaaaaaaa
aaaaaaaaaaaaaaaaaaaaaaaaaaaaaaaaaaaaaaaaaaaaaaaaaaaaaaaaaaaaaaaaaaaaaaaaaaaaaaaaaaaaaaaaaaaaaaaaaaaa
aaaaaaaaaaaaaaaaaaaaaaaaaaaaaaaaaaaaaaaaaaaaaaaaaaaaaaaaaaaaaaaaaaaaaaaaaaaaaaaaaaaaaaaaaaaaaaaaaaaa
aaaaaaaaaaaaaaaaaaaaaaaaaaaaaaaaaaaaaaaaaaaaaaaaaaaaaaaaaaaaaaaaaaaaaaaaaaaaaaaaaaaaaaaaaaaaaaaaaaaa
"}
